NO ./north
SO ./south
WE ./west
EA ./west
F 220,100,0
C 0,255,0


1111111
1E00001
1000001
1000001
1111111
